// Posicion inicial x, y (contando desde 0), mapa
4 7
T T T T T T T T T T
T - - - - - - - - T
T - - - - - - - - T
T - - - - - - O - T
T - - - - - - - - T
T - - - - - - - - T
T - - - - - - - - T
T - - - - - - - - T
T - - - - - - - - T
T T T T T T T T T T
