// Posicion inicial x, y (contando desde 0), mapa
4 2
T T T T T T T T T T
T - - - - - - - - T
T - - - - - - - - T
T - O - - - - - - T
T - - - - - - - - T
T - - - - - - - - T
T - - - - - - - - T
T - - - - - - - - T
T - - - - - - - - T
T T T T T T T T T T
